11111111111111111111111111
100P0000111111111000000E01
10000000111111111000000001
100C00000000000000000C0001
11111111110000011111111111
111111111100C0011111111111
10000000000000000000000001
100C0000011111111100C00001
10000000011111111100000001
11111111111111111111111111